133 38
####################################################################################################################################
#0000000000000000000000000000000000000000000000000000000000000000000000000000000000000000000000000000000000000000000000000000000000#
#0000000000000000000000000000000000000000000000000000000000000000000000000000000000000000000000000000000000000000000000000000000000#
#0000000000000000000000000000000000000000000000000000000000000000000000000000000000000000000000000000000000000000000000000000000000#
#0000000000000000000000000000000000000000000000000000000000000000000000000000000000000000000000000000000000000000000000000000000000#
#0000000000000000000000000000000000000000000000000000000000000000000000000000000000000000000000000000000000000000000000000000000000#
#0000000000000000000000000000000000000000000000000000000000000000000000000000000000000000000000000000000000000000000000000000000000#
#0000000000000000000000000000000000000000000000000000000000000000000000000000000000000000000000000000000000000000000000000000000000#
#0000000000000000000000000000000000000000000000000000000000000000000000000000000000000000000000000000000000000000000000000000000000#
#0000000000000000000000000000000000000000000000000000000000000000000000000000000000000000000000000000000000000000000000000000000000#
#0000000000000000000000000000000000000000000000000000000000000000000000000000000000000000000000000000000000000000000000000000000000#
#0000000000000000000000000000000000000000000000000000000000000000000000000000000000000000000000000000000000000000000000000000000000#
#0000000000000000000000000000000000000000000000000000000000000000000000000000000000000000000000000000000000000000000000000000000000#
#0000000000000000000000000000000000000000000000000000000000000000000000000000000000000000000000000000000000000000000000000000000000#
#0000000000000000000000000000000000000000000000000000000000000000000000000000000000000000000000000000000000000000000000000000000000#
#0000000000000000000000000000000000000000000000000000000000000000000000000000000000000000000000000000000000000000000000000000000000#
#00000000000000000000000000000000000000000000000000000000000####0000000000000000000000000000000000#####0000000000000000000000000000#
#0000000000000000000000000000%%%%%%%%%0000000000000000000000000%%%%000000000000####000000000000000000000000000####00000000000000000#
#00000000000000000000##################################################################00000000000000000000000000000000000000000000#
#00000000000000000000000000000000000000000####0000000000000000000000000000000000000000000000000000000000000000000000000000000000000#
#000000000000000000000000000####000000000000000000000000000000000000000000000000000000000000000000000000000000000000000000000000000#
#0000000000000000000000000000000000000000000000000000000000000000000000000000000000000000000000000000000000000000000000000000000000#
#0000000000000000000###000000000000000000000000000000000000000000000000000000000000000000000000000000000000000000000000000000000000#
#0000000000000%%%000000000000000000000000000000000000000000000000000000000000000000000000000000000000000000000000000000000000000000#
#000000000000#####00000000000000000000000000000000000000000000000000000000000000000000000000000000000000000000000000000000000002222#
#0000000000000000000C000E0000000000000000000000000000000000000000000000000000000000000000000000000000000000000000000000000000002222#
#0000000000#00000000000000000000000000000000000000000000000000000000000000000000000000000000000000000000000000000000000000000002222#
#%%%%%%%%%%00000%%%%%%%%%%%%%00000%%%%%%%%%%%%%%%%%%%%%%%%%%%%%%%%00000000000%%%%%%%%%%%%%%0000%%%%%%%%%00000%%%%%%%%%0%%%%%%%%%%%%#
####################################################################################################################################
####################################################################################################################################

