133 30#00000000000000000000000000000000000000000000000000000000000000000000000000000000000000000000000000000000000000000000000000000000000
#00000000000000000000000000000000000000000000000000000000000000000000000000000000000000000000000000000000000000000000000000000000000
#00000000000000000000000000000000000000000000000000000000000000000000000000000000000000000000000000000000000000000000000000000000000
#00000000000000000000000000000000000000000000000000000000000000000000000000000000000000000000000000000000000000000000000000000000000
#0000000000000000000000000O000000000000000000000000000000000000000000000000000000000000000000000000000000000000000000000000000000000
#00000000000000000000000000000000000000000000000000000000000000000000000000000000000000000000000000000000000000000000000000000000000
#00000000000000000000000000000000000000000000000000000000000000000000000000000000000000000000000000000000000000000000000000000000000
#00000000000000000000000000000000000000000000000000000000000000000000000000000000000000000000000000000000000000000000000000000000000
#00000000000000000000000000000000000000000000000000000000000000000000000000000000000000000000000000000000000000000000000000000000000
#00000000000000000000000000000000000000000000000000000000000000000000000000000000000000000000000000000000000000000000000000000000000
#00000000000000000000000000000000000000000000000000000000000000000000000000000000000000000000000000000000000000000000000000000000000
#00000000000000000000000000000000000000000000000000000000000000000000000000000000000000000000000000000000000000000000000000000000000
#00000000000000000000000000000000000000000000000000000000000000000000000000000000000000000000000000000000000000000000000000000000000
#00000000000000000000000000000000000000000000000000000000000000000000000000000000000000000000000000000000000000000000000000000000000
#000000000000000000000O0000000000000000000000000000000000000000000000000000000000000000000000000000000000000000000000000000000000000
#000000000000000000000000000000000000000#00000000E0000000000000000000000000000000000000000000000000000000000000000000000000000000000
#0000000000000000000000000000000000000000000000000000000000000000000000000000000000000000000000000#####00000000000000000000000000000
#0000000000000000000000000000000000000000000000000000000000000000000000000000000000000000000000000000000000000####000000000000000000
#00000000000000000000##################################################################000000000000000000000000000000000000000000000
#00000000000000000000000000000000000000000####00000000000000000000000000000000000000000000000000000000000000000000000000000000000000
#00000000000000000000000000000000000000000000000000000000000000000000000000000000000000000000000000000000000000000000000000000000000
#00000000000000000000000000000000000000000000000000000000000000000000000000000000000000000000000000000000000000000000000000000000000
#00000000000000000000000000000000000000000000000000000000000000000000000000000000000000000000000000000000000000000000000000000000000
#0000000000000000000000000000000000000000000000000000000000000000000000000000E000000000000000000000000000000000000000000000000000000
#000000000000#####000000000000000000000000000E000000000000000000000000000000000000000000000000000000000000000000000000000000000WWWWW
#00C000000000000000000000E00000000000000000000000000000000000000000000000000000000000000000000000000000E00000000000000000000000WWWWW
#000000000000000000000000000000000000000000000000000000000000000000000000000000000000000000000000000000000000000000000000000000WWWWW
#000000000000000000000000000000000000000000000000000000000000000000000000000000000000000000000000000000000000000000000000000000WWWWW
####################################################################################################################################
%%%%%%%%%%%%%%%%%%%%%%%%%%%%%%%%%%%%%%%%%%%%%%%%%%%%%%%%%%%%%%%%%%%%%%%%%%%%%%%%%%%%%%%%%%%%%%%%%%%%%%%%%%%%%%%%%%%%%%%%%%%%%%%%%%%%
