133 30#000000000000000000000000000000000000000000000000000000000000000000000000000000000000000000000000000000000000000000000000000000000#
#0000000000000000000000000000000000000000000000000000000000000000000000000000000000000000000000000000000000000000000000000000000000#
#0000000000000000000000000000000000000000000000000000000000000000000000000000000000000000000000000000000000000000000000000000000000#
#0000000000000000000000000000000000000000000000000000000000000000000000000000000000000000000000000000000000000000000000000000000000#
#0000000000000000000000000O00000000000000000000000000000000000000000000000000000000000000000000000000000000000000000000000000000000#
#0000000000000000000000000000000000000000000000000000000000000000000000000000000000000000000000000000000000000000000000000000000000#
#0000000000000000000000000000000000000000000000000000000000000000000000000000000000000000000000000000000000000000000000000000000000#
#0000000000000000000000000000000000000000000000000000000000000000000000000000000000000000000000000000000000000000000000000000000000#
#0000000000000000000000000000000000000000000000000000000000000000000000000000000000000000000000000000000000000000000000000000000000#
#0000000000000000000000000000000000000000000000000000000000000000000000000000000000000000000000000000000000000000000000000000000000#
#0000000000000000000000000000000000000000000000000000000000000000000000000000000000000000000000000000000000000000000000000000000000#
#0000000000000000000000000000000000000000000000000000000000000000000000000000000000000000000000000000000000000000000000000000000000#
#0000000000000000000000000000000000000000000000000000000000000000000000000000000000000000000000000000000000000000000000000000000000#
#0000000000000000000000000000000000000000000000000000000000000000000000000000000000000000000000000000000000000000000000000000000000#
#000000000000000000000O000000000000000000000000000000000000000000000000000000000000000000000000000000000000000000000000000000000000#
#000000000000000000000000000000000000000#00000000E000000000000000000000000000000000000000000000000000000000000000000000000000000000#
#0000000000000000000000000000000000000000000000000000000000000000000000000000000000000000000000000#####0000000000000000000000000000#
#0000000000000000000000000000000000000000000000000000000000000000000000000000000000000000000000000000000000000####00000000000000000#
#00000000000000000000##################################################################00000000000000000000000000000000000000000000#
#00000000000000000000000000000000000000000####0000000000000000000000000000000000000000000000000000000000000000000000000000000000000#
#0000000000000000000000000000000000000000000000000000000000000000000000000000000000000000000000000000000000000000000000000000000000#
#0000000000000000000000000000000000000000000000000000000000000000000000000000000000000000000000000000000000000000000000000000000000#
#0000000000000000000000000000000000000000000000000000000000000000000000000000000000000000000000000000000000000000000000000000000000#
#0000000000000000000000000000000000000000000000000000000000000000000000000000E00000000000000000000000000000000000000000000000000000#
#000000000000#####000000000000000000000000000E000000000000000000000000000000000000000000000000000000000000000000000000000000000WWWW#
#00C000000000000000000000E00000000000000000000000000000000000000000000000000000000000000000000000000000E00000000000000000000000WWWW#
#000000000000000000000000000000000000000000000000000000000000000000000000000000000000000000000000000000000000000000000000000000WWWW#
#000000000000000000000000000000000000000000000000000000000000000000000000000000000000000000000000000000000000000000000000000000WWWW#
####################################################################################################################################
%%%%%%%%%%%%%%%%%%%%%%%%%%%%%%%%%%%%%%%%%%%%%%%%%%%%%%%%%%%%%%%%%%%%%%%%%%%%%%%%%%%%%%%%%%%%%%%%%%%%%%%%%%%%%%%%%%%%%%%%%%%%%%%%%%%#
