133 30
####################################################################################################################################
#0000000000000000000000000000000000000000000000000000000000000000000000000000000000000000000000000000000000000000000000000000000000#
#0000000000000000000000000000000000000000000000000000000000000000000000000000000000000000000000000000000000000000000000000000000000#
#0000000000000000000000000000000000000000000000000000000000000000000000000000000000000000000000000000000000000000000000000000000000#
#0000000000000000000000000000000000000000000000000000000000000000000000000000000000000000000000000000000000000000000000000000000000#
#0000000000000000000000000000000000000000000000000000000000000000000000000000000000000000000000000000000000000000000000000000000000#
#0000000000000000000000000000000000000000000000000000000000000000000000000000000000000000000000000000000000000000000000000000000000#
#0000000000000000000000000000000000000000000000000000000000000000000000000000000000000000000000000000000000000000000000000000000000#
#0000000000000000000000000000000000000000000000000000000000000000000000000000000000000000000000000000000000000000000000000000000000#
#000000000000000000000o000000000000000000000000000000000000000000000000000000000000000000000000000000000000000000000000000000000000#
#0000000000000000000000000000000000000000000000000000000000000000000000000000000000000000000000000000000000000000000000000000000000#
#0000000000000000000000000000000000000000000000000000000000000000000000000000000000000000000000000000000000000000000000000000000000#
#0000000000000000000000000000000000000000000000000000000000000000000000000000000000000000000000000000000000000000000000000000000000#
#0000000000000000000000000000000000000000000000000000000000000000000000000000000000000000000000000000000000000000000000000000000000#
#0000000000000000000000000000000000000000000000000000000000000000000000000000000000000000000000000000000000000000000000000000000000#
#000000000000000000000000000000000000000#00000000E000000000000000000000000000000000000000000000000000000000000000000000000000000000#
#0000000000000000000000000000000000000000000000000000000000000000000000000000000000000000000000000#####0000000000000000000000000000#
#0000000000000000000000000000%%%%%%%%%0000000000000000000000000%%%%0000000000000000000000000000000000000000000####00000000000000000#
#00000000000000000000##################################################################00000000000000000000000000000000000000000000#
#00000000000000000000000000000000000000000####0000000000000000000000000000000000000000000000000000000000000000000000000000000000000#
#0000000000000000000000000000000000000000000000000000000000000000000000000000000000000000000000000000000000000000000000000000000000#
#0000000000000000000000000000000000000000000000000000000000000000000000000000000000000000000000000000000000000000000000000000000000#
#0000000000000000000000000000000000000000000000000000000000000000000000000000000000000000000000000000000000000000000000000000000000#
#0000000000000%%%000000000000000000000000000000000000000000000000000000000000E00000000000000000000000000000000000000000000000000000#
#000000000000#####000000000000000000000000000E0000000000000000000000000000000000000000000000000000000000000000000000000000000002222#
#00C000000000#####000000E000000000000000000000000000000000000000000000000000000000000000000000000000000E000000000000000000000002222#
#0000000000000000000000000000000000000000000000000000000000000000000000000000000000000000000000000000000000000000000000000000002222#
#%%%%%%%%%%00000%%%%%%%%%%%%%00000%%%%%%%%%%%%%%%%%%%%%%%%%%%%%%%%00000000000%%%%%%%%%%%%%%0000%%%%%%%%%00000%%%%%%%%%0%%%%%%%%%%%%#
####################################################################################################################################
####################################################################################################################################

