38 30
#####################################
#00000000000002222220000000000000000#
#00000000000002222220000000000000000#
#00000000000002222220000000000000000#
#00000000000000000000000000000000000#
#00000000000000000000000000000000000#
#00000000000000000000000000000000000#
#00000000000000000000000000000000000#
#00000000000000000000000000000000000#
#00000000000000000000000000000000000#
#00000000000000000000000000000000000#
#00000000000000000000000000000000000#
#00000000000000000000000000000000000#
#00000000000000000000000000000000000#
#00000000000000000000000000000000000#
#00000000000000000000000000000000000#
#00000000000000000000000000000000000#
#00000000000000000000000000000000000#
#0000000000000000C000000000000000000#
#00000000000000000000000000000000000#
#00000000000000000000000000000000000#
#00000000000000000000000000000000000#
#00000000000000000000000000000000000#
#00000000000000000000000000000000000#
#00000000000000000000000000000000000#
#00000000000000000000000000000000000#
#00000000000000000000000000000000000#
#00000000000000000000000000000000000#
#####################################
